XXXXSXXXXXXXX
X      XX   X
X XXXX XX X X
X   XX XX X X
XXXXX     X X
X     XXXXX X
X XXXXX     X
XXXXXXXFXXXXX
