XSXXXXXXXXXXXXXXXXXXXXXXXXXXXX
X X         XX               X
X XXX XXXXX XX XXXX XXXXXXXX X
X     XX XX XXXXXXX XX    XX X
XXXXX XX            XX XX XX X
XX XX XXXXXXXXXXXXXXXX XX XX X
XX                     XX XX X
XXXXX XXXXXXX XXXXXXXXXXX XX X
X   X X    XX X           XX X
X X X X XX XX X XXX XXXXXXXX X
X XXX X XX XX XXXXX XX       X
X      X X XX     X XX XXXXXXX
XXXXXX X X XXXXXX X XX XXXXX X
X        X        X XX       X
XXXXXXXXXXXXXXXXXXXFXXXXXXXXZX
