XXXXXXXXXXXXXXXXXXXXXXXXXXXXXX
XOX         XX               X
X XXX XXXXX XXOXXXX XXXXXXXX X
X     XX XX XXXXXXX XX    XX X
XXXXX XX            XX XX XX X
XX XX XXXXXXXXXXXXXXXX XX XX X
XX                     XX XX X
XXXXX XXXXXXX XXXXXXXXXXX XX X
X   X X    XX X           XX X
X XOX X XX XX X XXX XXXXXXXX X
X XXX XOXX XX XXXXX XX       X
X      XOX XX     X XX XXXXXXX
XXXXXX X X XXXXXX X XX XXXXXOX
X        X        X OX       X
XXXXXXXXXXXXXXXXXXXXXXXXXXXXXX
